Mm, Mm, Mm, Mm, Hh^Fp, Hh^Fp, Ww, Gs^Fms, Gs^Fms, Gg, Gs^Fms, Gg, Gg, Gg, Gg, Gg, Rrc, Re, Re, Gg, Gg, Mm, Mm, Mm, Mm
Mm, Mm, Hh^Fp, Hh^Fp, Hh, Hh, Ww, Gs^Fms, Gs^Fms, Gs^Fms, Gs^Fms, Gg, Gg, Gg, Gg, Re, Rrc, Rrc, Gg, Gg, Gg, Hh, Hh, Mm, Mm
Mm, Mm, Hh, Hh^Fp, Hh, Gs^Vh, Wwrg, Ww, Ds, Gg, Gg, Gg, Gg, Gg, Re, Re, Rrc, Gg, Gg, Ce, 1 Ke, Gg, Gg^Fds, Hh, Mm
Hh, Hh, Hh, Hh, Gg, Gg, Ds, Ds, Gg, Gg, Gg^Efm, Gg, Gg, Gg, Rrc, Rrc, Gg, Gg, Gg, Gg, Ce, Gg^Fds, Gg, Hh, Hh^Fp
Gg, Gg, Gg, Gs^Fds, Gs^Fds, Gg, Gg, Gg, Ds, Gg^Efm, Gg^Efm, Gg, Rrc, Rrc, Gg, Gg, Gs^Fds, Gg, Gg, Gg, Gg, Gg, Gg, Hh^Fp, Mm^Fp
Gg, Gg, Gg, Gs^Fds, Gg, Gg, Ds, Ds, Ww, Gg^Efm, Ce, Rrc, Rrc, Re, Gg, Gs^Fds, Gg, Gs^Fds, Gg, Gg, Gg, Gg^Efm, Hh^Vh, Hh, Mm
Gg, Gg, Gg, Gs^Fds, Gg, Gg, Gg, Ww, Ww, Ww^Ewl, Re, Re, Re, Rr^Vhc, Gg, Gg, Gg^Eff, Gg, Gg, Gg, Gg, Gg^Efm, Gg, Hh, Mm
Gg, Gg, Gs^Fds, Gs^Fds, Gg, Gg, Gg, Gg, Gg, Wwf, Rrc, Re, Cer, Gg, Gs^Fds, Ww, Wwr, Gg^Eff, Gg^Fet, Gg, Gg^Efm, Gg^Efm, Gg^Fds, Hh, Mm
Gg, Gg, Gg, Gd^Vo, Gg, Gg, Gg, Gg, Rrc, Rrc, Gg, Rrc, Gg, Gg, Gg, Gs^Fds, Gg, Wwf, Wwf, Gg, Gg^Fds, Gg^Fds, Gg^Fds, Mm, Mm
Gg, Gg, Gg, Gg, Gg, Gg, Rrc, Rrc, Rrc, Gg, Gg, Gg, Gg, Gg, Gg, Gs^Fds, Gg, Gg, Ww, Ww, Gg^Fds, Gg^Fds, Hh, Hh, Hh
Gd, Gg, Gd, Gg, Gg, Re, Rrc, Rrc, Gg, Gg, Gd, Gg, Gg, Gg, Gd^Vhr, Gs^Fds, Gg, Gg, Gg, Gg, Hh, Hh, Mm, Mm, Mm
Gd, Gd, Gg, Gg, Re, Rrc, Gg, Gg, Gd, Gd, Gg, Gd, Gg, Gg, Gg, Gg, Gd, Gd, Gd, Gg, Hh, Hh, Gg, Mm, Gg
